8 23
11111111111111111111111
10222222130003122222221
12211222112221122211221
12212222222222222221221
12212212222222221221221
12211212111111121211221
12222222222222222222221
11111111111111111111111
1 1