6 21
111111111111111111111
100100001000000000121
100111001000000000111
100000001000010000001
100000000000000000001
111111111111111111111
1 1