6 21
111111111111111111111
100100001000000000021
100111031003011111111
100030001000010030001
100000000000300000001
111111111111111111111
1 1